111111111111111
1P00000000000C1
100101111111111
1E0100000000011
101101111111111
101101111111111
101101111111111
101101111111111
101101111111111
111111111111111