11111
1CEP1
11101
10001
10001
11111